XXXXXXXXXXXXXXXXXXXXXXXXXXXXXXXXXXXXXXXXX
P       X       X       X       X       X
XXXXX X XXX XXX X XXXXX XXX XXX XXX XXXXX
X     X X   X X X   X       X X   X     X
X XXXXX X XXX X X X XXXXXXXXX XXX X XXX X
X X   X   X     X X         X     X X   X
X X X XXXXX XXXXXXXXX XXXXX X XXXXXXX X X
X X X     X   X     X   X   X       X X X
X XXX X XXXXX X XXX XXXXX XXXXXXXXX X X X
X   X X         X         X     X   X X X
XXX XXX XXXXXXXXXXXXXXXXXXX XXX X XXX X X
X X   X   X   X         X X   X   X   X X
X XXX X XXX X X XXXXXXX X XXX XXXXX XXX X
X   X X X   X X X     X X   X       X X X
XXX X XXX XXX X X XXX X X X XXXXXXXXX X X
X   X   X   X   X   X X X X X           X
X XXXXX XXX XXXXX X X X X XXX XXXXXXXXXXX
X     X     X     X X X X   X       X   X
X XXX XXXXXXXXXXXXX XXX XXX XXXXXXX X XXX
X   X               X   X       X X X   X
XXX XXXXXXX XXXXX XXX XXX XXXXX X X X X X
X         X X   X X   X X     X   X X X X
XXXXXXX XXX X X X X XXX X XXX XXXXX XXX X
X   X   X   X X   X     X X X     X     X
X X XXXXX XXX XXXXX X X X X XXXXX XXXXX X
X X       X     X   X X X   X X       X X
X XXXXXXX XXXXXXX XXX XXXXX X X XXXXXXX X
X X     X X     X   X     X   X   X     X
X X XXX XXX XXX XXX X XXX XXX XXX X XXXXX
X X   X   X   X     X X X     X       X X
X X XXXXX XXX XXXXXXX X XXXXXXX XXXXX X X
X   X       X X   X   X         X X X   X
XXXXX XXXXX X X X X XXXXX X XXX X X XXX X
X     X   X X   X X     X X X     X X X X
X XXXXX XXX XXXXX XXXXX X X X XXXXX X X X
X X         X     X   X X X     X   X   X
X XXXXX XXX X XXXXX X X X XXXXX X XXX XXX
X     X X   X     X X     X   X X   X X X
X XXX X X X XXXXX XXXXXXX X X XXXXX X X X
X   X     X X   X     X   X X X     X X X
XXXXX XXXXX X XXXXXXX XXXXX X X XXXXX X X
X     X   X   X     X     X X X   X     X
X XXXXX XXXXX X XXX XXXXX X X XXX XXXXX X
X     X   X       X     X   X   X     X X
XXXXX XXX X XXXXX XXXXX XXXXX XXXXXXX X X
X     X   X X   X     X     X         X X
X XXXXX XXX X XXXXXXX XXXXX XXXXXXXXXXX X
X   X   X     X       X   X           X X
XXX X XXX XXXXX XXXXXXX XXXXXXXXXXX XXX X
X   X   X X X   X           X   X   X   X
X XXXXX X X X XXX XXXXXXX XXX X X XXX XXX
X     X X X X X     X   X     X X X   X X
XXXXX X X X X X XXXXX X X XXXXX X X XXX X
X     X     X         X X     X X X     X
X XXX XXXXX XXXXXXXXXXX XXXXXXX X XXXXX X
X   X X   X X         X         X   X X X
X X XXX X X X XXXXXXX XXXXXXX XXX X X X X
X X X   X X   X     X X X     X   X   X X
X X X XXX X XXXXX XXX X X XXXXX X XXXXX X
X X   X   X X   X X   X X   X X X X   X X
X XXXXX XXXXX X X X XXX XXX X X XXX X X X
X     X X     X X X X     X   X     X X X
XXXXX X X XXXXX X X X XXXXXXX XXXXXXX X X
X X   X X X   X X     X       X     X   X
X X XXX X XXX X XXXXX X XXXXXXX XXXXXXXXX
X X X X   X   X   X X X   X   X         X
X X X XXXXX XXXXX X X XXX X X XXX X XXXXX
X   X     X     X X     X   X   X X     X
X XXX X XXX XXX X XXXXX XXXXXXX XXX XXX X
X X   X     X   X     X X     X   X   X X
X X XXXXXXXXX XXXXXXX X X XXX XXX XXXXX X
X X     X   X       X X X X X   X X     X
X XXXXXXX X XXXXX X X XXX X XXX X X XXX X
X X       X       X X     X   X X   X   X
X X XXXXXXXXXXXXXXX XXXXXXX X X XXXXX XXX
X   X   X   X       X       X X   X   X X
XXXXX X X X X XXXXXXX XXXXXXXXX XXX XXX X
X X   X   X X   X             X     X   X
X X XXXXXXX XXX X XXXXXXXXXXX XXXXXXX X X
X   X     X   X X X         X     X   X X
X XXXXX X XXX X X X XXXXXXX X XXX X XXXXX
X X   X X   X X   X     X     X   X X   X
X X X X XXX X X X XXXXX XXXXXXX XXX X X X
X X X   X X X X X X   X   X     X   X X X
X X XXXXX X X X X X XXXXX X XXXXX XXX X X
X X   X   X X   X X X     X     X     X X
X XXX X XXX XXXXX X X XXXXXXXXX XXXXXXX X
X X   X   X X   X   X         X       X X
X X XXX X X XXX X X XXXXXXXXX XXXXXXX X X
X   X X X   X   X X       X   X     X X X
XXXXX X XXXXX X X X XXXXX X XXXXXXX X X X
X X     X     X X X       X       X X   X
X X XXXXX XXX X X XXXXX X XXXXXXX X XXX X
X X   X   X X X X X     X     X   X X   X
X XXX X XXX X XXX XXXXXXXXXXX X XXX X XXX
X   X X     X                 X X   X X X
X X X XXXXX XXXXXXXXXXXXXXX XXX X XXX X X
X X X   X           X       X   X       X
X X XXX XXXXX XXXXX XXXXXXX X XXXXXXXXXXX
X X   X X     X   X       X X           X
XXX X X X XXXXX XXXXXXXXX X XXXXXXX XXX X
X   X X   X               X   X   X   X X
X XXXXXXXXXXXXXXX XXXXX X X XXX X XXXXX X
X       X       X X   X X       X X     X
X XXX XXX X XXX XXX X X XXXXXXXXX X XXX X
X   X   X X   X     X X X       X   X   X
XXXXXXX X XXX XXXXXXX X X X XXX XXXXX XXX
X       X   X   X   X X X X X   X X   X X
X XXXXXXXXX XXX X XXX X X X X XXX X XXX X
X X   X     X   X       X X X   X X   X X
X X X X XXXXX XXX XXX XXX X XXX X XXX X X
X   X   X   X       X X   X   X     X   X
X XXXXXXX X XXXXXXX X X XXXXX X XXXXXXX X
X   X     X       X X X X X   X X     X X
XXX X XXXXXXXXXXX X XXX X X XXXXX X XXX X
X X X X           X X   X X       X     X
X X X X XXXXXXXXX X X XXX XXXXXXXXXXXXXXX
X   X X     X   X X X             X     X
X XXXXXXXXX XXX X X XXXXXXXXXXXXX X XXX X
X         X   X   X         X X   X X X X
XXXXXXXXX XXX XXXXXXXXX XXX X X XXX X X X
X       X   X   X     X   X   X X       X
X XXXXXXXXX X X X XXX XXX XXXXX X X XXXXX
X   X     X X X     X   X     X X X X   X
XXX X X XXX XXXXXXX XXX XXXXX X X X X X X
X   X X   X X     X   X     X   X X   X X
X XXX XXX X X XXX XXXXXXXXX XXXXXXXXXXX X
X     X X   X X X         X             X
X XXXXX XXXXX X XXXXXXXXX X XXXXXXXXXXX X
X             X     X   X   X           X
XXXXXXXXXXXXXXXXXXX X X XXXXX XXXXX X XXX
X   X             X   X           X X   X
X X XXXXXXXXX XXX XXX XXXXXXXXXXX XXXXX X
X X     X   X X     X X         X X     X
X XXXXX X X X XXXXX XXX XXXXXXX X X XXXXX
X X   X   X X     X     X     X     X   X
X X X XXXXX XXXXX XXXXXXX X XXXXX X XXX X
X X X             X     X X X   X X   X X
X XXXXXXXXXXXXXXX X XXX XXX X X X XXX X X
X X   X       X X X   X   X   X     X X X
X X X X XXXXX X X XXX XXX X XXXXXXXXX X X
X   X       X X   X   X   X   X   X   X X
X XXXXXXXXXXX X XXX XXX XXX XXX X X XXX X
X   X   X     X X   X X X   X   X   X   X
XXX X X X XXXXXXX XXX X XXXXX XXXXXXXXX X
X   X X X         X   X   X   X   X     X
X XXX X XXXXXXXXXXX X XXX X XXX X X X X X
X     X X   X     X X   X   X   X X X X X
XXXXXXX X X X XXX XXX X XXXXX XXX X X X X
X     X   X X X   X   X X     X   X   X X
X XXXXXXXXX X X XXX XXX X XXXXX XXXXX XXX
X X       X   X     X   X           X   X
X X X XXXXXXXXXXXXXXX XXX XXXXXXXXX XXX X
X   X   X         X X X   X       X   X X
XXXXXXX X XXXXX X X X XXX X XXXXX XXX X X
X       X X   X X   X   X   X   X   X X X
X XXXXX X X X X XXX XXX XXX X X XXX X X X
X   X   X   X X X     X   X   X X   X   X
X X XXXXXXXXX X X X XXXXX XXXXXXX XXXXX X
X X           X   X               X     K
XXXXXXXXXXXXXXXXXXXXXXXXXXXXXXXXXXXXXXXXX
