XXXXXXXXXXXXXXXXXXXXXXXXXXXXXXXXXXXXXXXXXXXXXXXXXXX
P     X X     X     X             X         X     X
XXX X X X XXX X X XXX XXXXX XXXXX XXXXXXX X X XXX X
X   X   X   X   X     X X   X   X         X X X   X
X XXXXX XXX XXXXXXXXXXX X XXX XXXXXXXXXXXXX XXX X X
X     X   X   X X       X X       X       X X   X X
XXXXX X XXXXX X X XXXXX X XXXXX X X XXX XXX X XXX X
X     X X   X X   X     X     X X X   X     X X   X
X XXXXX X X X X XXX XXX XXXXX X X XXX XXXXXXX XXX X
X X     X X   X   X   X X   X X X X X X     X   X X
X XXXXXXX XXXXX XXXXX XXX X X X X X X X XXX XXX X X
X X       X X   X   X     X X X X   X   X   X   X X
X X XXXXXXX X XXX X XXXXXXX X X XXXXXXXXX XXX XXX X
X X X       X   X X   X   X X X         X     X X X
X X XXX XXXXX XXX XXX X X X X XXX XXX X XXXXXXX X X
X X   X       X   X     X   X   X X X X     X     X
X XXX XXX XXXXX X XXXXX XXXXXXX X X X XXXXXXX XXXXX
X   X   X X   X X X   X X     X X X X   X     X   X
X XXXXX X X X X XXX X X X XXX X X X XXX X XXXXX X X
X X     X   X X X   X X X   X X X   X X X   X   X X
X X XXXXXXXXX X X XXX XXXXX X X XXX X X XXX X XXX X
X X X     X   X X X X X   X X X X     X   X   X   X
X X X XXX X XXX X X X X X X X X XXXXX X X XXXXX XXX
X   X X   X X   X X   X X   X X     X X X   X   X X
X XXX X XXXXX XXX X XXX XXXXX XXXXX XXX XXXXX XXX X
X X   X       X   X   X X   X     X   X       X   X
X X X XXXXXXX X XXXXX X X XXXXXXX XXX X XXXXXXXXX X
X X X X       X     X   X           X X   X       X
X XXX XXXXXXXXX XXX XXXXX XXXXXXXXX X XXX X X XXX X
X     X   X   X X   X X   X       X   X   X X X   X
XXX XXX X X X XXX XXX X XXXXXXXXX XXXXX XXXXX XXXXX
X X X   X   X     X   X X     X   X   X X   X     X
X X X XXX XXXXXXXXX XXX X XXX X XXXXX X X X XXXXX X
X   X X   X     X       X X X   X     X X X   X   X
XXXXX X XXX XXX XXXXXXXXX X XXXXX XXX X X XXX X XXX
X   X X   X X X           X       X X X X X X X   X
X X X XXX X X XXXXXXXXXXXXX XXXXXXX X X X X X XXX X
X X X X   X   X       X   X     X     X   X X     X
X X X XXXXXXX X X X XXX X X XXX XXX XXXXXXX XXXXX X
X X   X       X X X X   X X   X   X     X       X X
X XXX X XXXXXXX X XXX XXX XXX XXX XXXXXXX X X XXX X
X   X X   X X   X     X     X X X     X   X X X   X
X X XXXXX X X XXXXXXXXX XXXXX X XXXXX X XXX XXX XXX
X X X     X   X       X             X X   X   X   X
XXX X XXXXXXX X XXX XXXXX XXXXXXXXX X XXX XXX XXX X
X   X   X   X   X   X   X   X     X X   X X X     X
X XXXXX X X XXXXXXXXX X X XXX XXX X XXX X X XXXXXXX
X     X X X           X X X   X X X   X           X
X X XXX X XXXXXXXXXXXXX XXX XXX X XXX XXXXXXXXXXX X
X X   X X X X         X     X X   X     X       X X
X XXX X X X X XXXXXXX XXXXXXX X XXXXXXXXX XXXXX XXX
X X   X   X   X       X   X   X           X   X   X
X X XXXXXXX XXX XXXXX X X XXX XXXXXXXXXXXXX XXXXX X
X X     X   X X     X   X       X       X         X
X XXXXX X XXX XXXXX XXXXXXXXXXX X XXX XXX XXXXXXXXX
X X   X X X       X       X     X X   X   X       X
X X X X X X X XXX XXXXXXX XXX XXXXX X X XXXXXXX X X
X   X X   X X   X   X   X   X       X X       X X X
XXXXX XXXXX XXX XXX X X XXX XXXXXXX XXXXXXXXX XXX X
X   X     X X X   X   X X   X     X X       X     X
X X XXXXX X X XXX XXXXX X X X XXX XXX X XXXXXXXXX X
X X X     X   X X X   X X X X   X     X         X X
X XXX XXXXXXX X X X X X X XXXXX XXXXXXXXXXXXX XXX X
X   X X     X   X X X   X       X     X X     X   X
XXX X X XXXXXXX X XXX XXXXXXXXXXXXX X X X XXXXX XXX
X   X X X       X   X X     X       X   X   X   X X
X XXX X X XXXXXXXXX X X X X X XXXXX XXXXX X X XXX X
X     X   X     X   X X X X   X   X X   X X X X   X
X XXXXXXXXX XXX X XXX X X XXXXX XXX X X XXX X XXX X
X       X   X   X   X X X   X       X X   X X   X X
XXXXXXX X XXX XXXXX X XXXXX XXXXXXX X XXX X XXX X X
X   X   X X X   X   X       X     X X X X X   X   X
X XXX XXX X XXX X XXXXXXXXX X XXX X X X X X X XXX X
X   X X   X     X   X X     X X X X X X   X X   X X
X X X XXX X XXXXXXX X X XXXXX X X XXX X XXXXXXX X X
X X X     X X       X   X     X   X   X         X X
X X XXXXXXX X XXXXXXX XXX XXXXX XXX XXXXXXXXX XXX X
X X       X X     X     X X   X X   X X       X   X
X X XXXXX X XXXXX X XXXXX X XXX XXX X X XXXXXXX XXX
X X X   X X     X X   X   X         X   X     X X X
X X X XXX XXXXX X XXX X XXXXXXXXXXXXXXX X XXX X X X
X X X     X   X X   X X           X   X X   X X   X
X X XXXXXXX X X X X X XXXXXXXXXXX X X X XXX X XXX X
X X         X X X X X X         X X X X   X X     X
X XXXXXXXXXXX X XXX X XXXXXXX X X X X X XXX XXXXXXX
X     X     X X     X         X X   X X X   X     X
XXXXX X XXX X XXXXXXXXXXXXXXXXX XXXXX XXX XXXXX X X
X X   X X X X X         X   X   X   X   X X     X X
X X XXX X X X X X XXXXX XXX X XXX XXXXX X XXX XXX X
X X X   X X X   X   X X   X X     X     X   X X   X
X X X XXX X XXXXXXX X XXX X XXXXX X XXXXXXX X X XXX
X   X X   X   X   X X   X   X X   X       X   X   X
X XXX XXX XXX X XXX X X XXX X X XXXXXXX XXXXXXXXX X
X X   X   X   X X   X X   X   X   X   X         X X
X XXX X XXX XXX X XXX XXX XXX XXX X X XXX XXXXX X X
X     X   X X   X X     X       X   X   X X   X X X
XXXXXXX X X X X X XXX XXXXXXXXXXXXXXXXX X X X XXX X
X     X X   X X X   X X     X       X   X X X     X
X X XXX XXXXXXX XXX XXX XXX X X XXXXX XXX X XXXXXXX
X X               X       X   X         X         K
XXXXXXXXXXXXXXXXXXXXXXXXXXXXXXXXXXXXXXXXXXXXXXXXXXX
