XXXXXXXXXXXXXXXXXXXXXXXXXXXXXXXXXXXXXXXXXXXXXXXXXXXXXXXXXXXXXXXXXXXXXXX
P                     X       X     X X           X         X     X   X
X XXX XXXXXXXXXXXXXXX X XXXXX X XXX X X XXXXXXX X XXXXXXX X XXX X XXX X
X   X   X         X   X X   X X   X X X X X     X         X X   X X   X
XXX XXX X X XXXXXXX XXX X X X XXX X X X X X XXXXXXXXXXXXXXX X XXX X XXX
X X X   X X X           X X       X   X X X   X     X     X X X X X   X
X X X XXX X X XXXXXXXXXXXXXXXXXXXXXXX X X XXX XXX X XXX X X X X X X X X
X   X   X X X   X   X     X       X   X X   X   X X     X X   X   X X X
XXXXXXX X X XXX X X X XXX X XXXXX XXXXX XXX XXX X XXXXXXXXXXXXX XXX X X
X       X X   X X X X   X   X   X             X X     X       X X   X X
X XXXXXXXXX XXX XXX XXX XXXXXXX XXXXXXXXXXXXXXX XXXXX X XXX XXX X XXX X
X     X   X   X   X   X X             X       X     X X X X X   X X   X
X XXX X X XXX XXX X XXX X XXXXXXXXXXX X XXXXX XXXXX X X X X X XXXXX X X
X   X   X   X       X   X   X       X X   X X       X   X X X       X X
X XXXXXXX X XXXXXXX X XXX X X XXXXXXX XXX X XXXXXXXXXXX X X XXXXXXXXX X
X X     X X     X   X X   X X X     X X X X       X   X   X         X X
XXX XXX XXXXXXX XXXXX XXXXX X X XXX X X X XXX XXX X X XXXXX XXXXX XXX X
X   X X X       X   X       X X   X     X X   X     X     X     X X   X
X XXX X X XXXXX X X XXXXXXXXX XXX XXXXXXX X XXXXXXXXXXXXX XXXXX X X XXX
X X     X X   X X X             X X       X       X             X X X X
X XXXXX X X XXX X XXXXXXXXXXXXX X X XXXXXXX XXXXX X XXXXXXXXXXXXX X X X
X X   X   X     X X       X   X   X X     X   X   X X   X       X X X X
X X X XXXXXXX XXX X X XXX X X XXXXX X XXX XXX X XXXXX X X XXXXXXX X X X
X   X X     X X X X X X X X X       X X   X   X   X   X X X       X X X
X XXX X XXX X X X XXX X X X XXXXXXXXX X X X XXXXX X XXX X X XXXXXXX X X
X X   X X   X   X     X   X       X   X X X X   X     X X X     X X   X
XXX XXX X XXXXX XXXXXXX XXXXXXXXX XXX X XXX XXX XXXXXXX X XXXXX X XXX X
X   X   X   X     X   X X       X   X X     X   X X     X           X X
X XXX XXXXX XXXXX X X X XXX XXX XXX X XXXXXXX X X X XXXXXXXXXXXXXXXXX X
X     X   X   X   X X X     X   X X X X       X   X   X       X       X
X XXXXX X XXX XXXXX X XXXXXXX XXX X X XXXXX X XXXXXXX X XXXXX X XXXXXXX
X     X X   X       X   X         X X   X   X X     X X X     X   X   X
XXXXX X X X XXXXXXXXXXX X XXXXXXXXX XXX X XXXXX XXX X X X XXX XXX X X X
X   X X X X X         X X   X       X X X         X X   X   X   X X X X
X X X X X X X XXXXX XXX XXX X XXXXXXX X XXXXXXXXXXX XXXXXXX XXXXX X X X
X X   X X X X   X   X   X   X   X X     X       X     X     X   X X X X
X XXXXX X X XXX X XXX X X XXXXX X X XXXXX XXXXX X X XXX XXX X X X XXX X
X   X   X X   X X X   X X X X   X X X     X   X X X X   X   X X   X   X
XXX XXXXX XXX XXX X X XXX X X XXX X X XXXXX XXX X XXX XXX XXX XXXXX XXX
X X X     X X X   X X X   X X   X X   X X     X   X   X     X X   X   X
X X X XXXXX X X X X X X XXX XXX X XXXXX X XXX XXX X XXXXXXXXX X X X X X
X   X   X   X   X X X X X   X X X X       X X     X   X     X   X X X X
X XXX X X XXXXXXX X XXX X X X X X X XXXXXXX XXXXXXXXX X XXX XXXXX XXX X
X X   X X X     X X   X   X   X X       X         X   X   X     X X   X
X XXX X X X XXX X XXX XXXXXXX X XXXXXXX X X XXXXX X XXXXX X XXXXX X XXX
X   X X X X X X X X X       X X   X     X X X   X X   X   X       X   X
XXX X X X X X X X X XXXXXXX X XXX X XXXXXXX X X XXXXX X XXXXXXX XXXXX X
X   X X X   X X   X       X   X   X X       X X X   X   X X   X       X
X XXXXX X XXX XXXXX XXXXX XXXXX XXX XXXXX X X X X X X XXX X X XXXXXXX X
X       X   X       X   X     X   X     X X X X   X X     X X   X   X X
XXXXXXXXXXX XXX XXXXX X X XXXXXXX XXXXX X X X XXXXX XXXXX X XXX X X XXX
X       X   X   X     X X X     X X   X   X X X   X     X X X   X X   X
X XXX XXX XXX XXX XXXXX X X XXX X X XXX XXXXX XXX XXXXX X X X XXX XXX X
X X   X   X         X   X X X X   X     X   X     X     X X X X     X X
X X X X XXX XXXXXXXXX X XXX X XXXXX XXXXX X XXXXX X XXXXX X X X XXXXX X
X X X X X X X   X     X X   X X         X X   X   X   X   X X   X   X X
X X XXX X X XXX X XXXXX X XXX X XXXXXXXXX XXX X XXXXX X XXX XXXXX X X X
X X X   X   X   X X     X X   X X         X X   X   X X X   X   X X   X
X X X XXX XXX X X XXXXXXX X X X X XXXXXXXXX XXXXX X X XXX XXX X X XXX X
X X X   X     X X       X X X   X X       X   X   X X     X   X X X   X
XXX XXX XXXXXXXXXXXXXXX X XXXXX X XXX XXX X X X XXXXXXXXXXX XXX X XXXXX
X   X   X   X       X   X     X X   X   X   X X X           X   X X   X
X XXX XXX X X XXXXX X X XXXXX X XXX X X XXXXX X X X XXXXXXXXX XXX X X X
X     X   X   X     X X     X X   X X X X   X X   X       X X   X   X X
X XXXXX XXXXXXX XXXXX XXXXXXX XXX X X X X XXX XXXXX XXXXX X XXX XXXXX X
X   X   X     X   X   X       X   X X X X   X     X     X X         X X
XXX X XXX X X XXX X X X XXXXXXXXXXX XXX XXX XXXXX X XXXXX XXXXXXXXX X X
X   X   X X X   X   X X       X   X   X   X     X X X     X   X     X X
X XXX X XXX XXXXXXX XXXXXXXXX X X XXX XXX X XXXXX X X XXXXX X XXXXXXX X
X X   X   X         X       X   X   X     X     X X X   X   X X     X X
X X XXXXX XXXXXXXXXXX XXXXX XXXXX XXXXXXXXX XXX X XXXXX XXXXX X XXX X X
X X     X X   X     X   X X       X       X X X   X   X X   X   X   X X
X XXXXX X X X X XXX XXX X X XXXXXXX X XXX X X XXXXX X X X X XXXXX XXX X
X X     X   X X   X     X X X       X X   X X       X X   X   X   X   X
X XXXXXXXXXXX XXX XXXXXXX X X XXXXXXX X XXX X X XXXXX XXXXXXX X XXX XXX
X     X     X   X   X       X     X X X   X X X X     X       X X     X
XXXXX X XXX X XXXXX XXXXX XXXXXXX X X XXXXX XXX X XXXXX XXXXX X XXX X X
X   X   X   X     X     X X X     X X       X   X X X   X     X   X X X
X XXXXXXX XXXXX X XXXXX X X X XXXXX XXXXXXXXX XXX X X X X XXXXXXX XXX X
X       X     X X   X   X   X X         X     X   X   X X   X   X   X X
X XXX XXXXXXX X XXX X XXXXXXX XXXXXXX X X X XXX XXX XXX XXX X X XXX X X
X X   X     X   X X X     X   X       X X X X X X     X X   X X X   X X
XXX X X XXX XXXXX X XXXXX X XXX XXXXXXX XXX X X XXXXXXX X XXX X X XXX X
X   X X   X       X   X   X     X     X X   X X     X   X     X X X   X
X XXXXX XXXXXXX XXXXX X XXXXXXXXXXX X X X XXX XXXXX X X XXXXXXXXX X XXX
X       X   X   X     X     X       X X   X       X   X X         X X X
XXXXXXX X X X X X XXXXXXXXX X X XXXXX XXXXX XXXXXXXXXXX X XXXXXXXXX X X
X     X X X X X X X     X X   X   X X X X               X X       X X X
X XXX XXX X X X X X X X X XXXXXXX X X X X XXXXXXXXXXXXXXX XXXXX X X X X
X X       X   X X X X X     X   X X X X X X       X     X     X X   X X
X XXXXXXXXXXXXX X XXX XXXXX X XXX X X X X XXX XXX XXX X XXXXX X XXXXX X
X   X         X X     X   X X X   X X X X     X X X   X     X   X     X
X X XXXXX XXXXX XXXXXXX XXX X X XXX X X XXXXXXX X X XXXXXXX XXXXX XXX X
X X     X X     X   X     X   X X   X   X       X X   X   X X   X X   X
X XXXXX X X XXXXX X X XXX X XXX X XXXXX X XXXXX X X X X X X X X XXX X X
X   X   X         X X   X   X   X   X   X     X   X X   X X   X     X X
X XXX XXXXXXXXXXXXXXXXX XXXXX XXX X X XXXXXXX XXXXXXXXX X XXXXXXXXXXX X
X X   X   X           X   X X X   X       X   X       X X     X     X X
X X XXX X X XXXXXXX XXXXX X X XXXXXXXXXXXXX XXXXXXX X XXXXXXX X XXX X X
X X     X         X         X                       X         X   X   K
XXXXXXXXXXXXXXXXXXXXXXXXXXXXXXXXXXXXXXXXXXXXXXXXXXXXXXXXXXXXXXXXXXXXXXX
